Google Docs: 온라인 문서 편집기
Canva Docs - 무료 온라인 문서 편집기 | Canva(캔바)
엠에디터 (문서 편집기) – 대용량 파일과 유니코드를 지원하는 ...
위키 : 올인원 협업툴 두레이, Let's Dooray
폴리지 툴 | 언리얼 엔진 문서
iLovePDF | PDF를 즐겨 쓰시는 분들을 위한 온라인 PDF 툴
PDF 편집 - 브라우저에서 바로 작동하는 무료 PDF 편집기
잔디 기능 | 업무용 협업툴 잔디(JANDI)
Asana를 기존 협업 툴과 함께 사용하는 방법
한컴오피스 Web : 한글과컴퓨터
문서편집기 | 케이벤치 다운로드
진단 도구 | Dell 대한민국
PowerShell용 Google Cloud Tools 문서
PDF 용량 줄이기 - 빠른, 온라인, 무료 - PDF24 Tools
사진 에디터 : Pixlr E - 무료 이미지 편집 툴
Tableau Resource Monitoring Tool 설치
Openproject 로드맵, 위키, 문서 관리 - Tools - 대시보드 - webnori
MiriCanvas | Free design tool with unique templates
MongoDB Documentation
iLoveIMG | 쉽고 빠른 온라인 무료 이미지 편집 툴
글로벌 47만 기업의 선택, 네이버웍스
Manage manifest files | Android Studio
프로덕트 디자인을 위한 툴
Canva(캔바) - 저작권 걱정 없는 무료 디자인 툴
인쇄물 디자인툴 - 카페24 스토어
Unity 2019.2: 새로운 아티스트 및 디자이너 툴
디자인 툴 - 컬러바다 - 디자이너를 위한 공간
디자인 툴 - 무료 교육개 아이콘 - Flaticon
MiriCanvas | Free design tool with unique templates
tooldi - 반가워 툴디, 디자인을 시작할게
DaVinci Resolve 18 - Blackmagic Design
온라인 사진 편집 프로그램 - Pixlr.com 이미지 편집
디자인 툴 디자이너를 위한 아이콘 리소스
마플 - MARPPLE
무료 온라인 동영상 편집기 | Adobe Express
무료 동영상 편집기 | Canva(캔바)
자동 자막 만들기 프로그램 - 브루 Vrew
DaVinci Resolve 18 - Blackmagic Design
꿀캠 - 최고의 움짤 제작 프로그램 - 반디소프트
동영상 편집 프로그램 뱁믹스2 무료 다운로드
파놉토 온라인 영상편집 프로그램 - Panopto
간편한 영상편집 프로그램ㅣ곰믹스 프로
무료 온라인 동영상 편집기 | Clipchamp - 빠르고 쉽게 이용하기

